{
	"hashcode": 2589,
	"board": [
		[8,1,5, 3,7,9, 2,4,6],
		[4,2,3, 8,1,6, 9,7,5],
		[9,6,7, 4,2,5, 8,1,3],

		[3,7,9, 5,8,2, 4,6,1],
		[2,4,1, 9,6,7, 5,3,8],
		[6,5,8, 1,4,3, 7,2,9],

		[7,3,2, 6,9,8, 1,5,4],
		[1,8,6, 2,5,4, 3,9,7],
		[5,9,4, 7,3,1, 6,8,2]
	],
	"display": [
		[0,1,1, 0,1,0, 0,0,0],
		[1,0,0, 0,0,0, 0,1,0],
		[0,1,0, 0,0,1, 0,0,1],

		[1,0,0, 0,0,0, 0,0,0],
		[0,0,1, 1,1,0, 1,1,0],
		[0,0,0, 1,0,0, 0,0,0],
		
		[0,1,1, 1,1,0, 0,0,1],
		[0,0,0, 1,0,0, 0,0,1],
		[0,0,0, 1,0,0, 1,1,0]
	]
}